1111111111
1100111111
0000011111
0000011000
0000011000
0000011000
0000011111
1111111111
1110000111
1110000111