1111111111
0111111111
0001110011
1111100000
0000011000
0000011111
0000011111
1111111111
1111111001
1111111001